1111111111111111111111111111111111
100000000000000C00000C000000000011
1010010100100000101001000000010101
101001001010101E001001000000010101
100000000C00C000000000000000000111
1011111111111111111111111111111P01
1000111111111111111111000000000111
1011111111111111111111111111111111
1010010100100000101001000000010101
1000000000000000000000011111110101
1010010100100000101100000001010111
1111111111111111111111111111111111
